%%%%%%%%%%%%%%%%%%%%%%%%%%%
%                         %
% %%%%%%%%%%%%        %%% %
%                 %%      %
%     .           %%      %
%          %         %    %
% %%%%%%   %%% %%    %  %G%
%         P          %%%%%%
% %%%%%%    %   .    %    %
% %    %    %             %
% %  G %    %  %%%%%%%%   %
% %    %    %             %
% %    %    %  %%%%%%%%   %
%           %    G        %
%     %%    %  %%    %%   %
%     %%    %             %
%          G%             %
%%%%%%%%%%%%%%%%%%%%%%%%%%%
% % % % %%%%%%%%%%%%%%%%%%%
%%%%%%%%%%%%%%%%%%%%%%%%%%%