%%%%%%%%%%%%%%%%%%%%%%%%%%%
%                         %
% %%%%%%%%%%%%        %%% %
%                 %%      %
%     .           %%      %
%          %         %    %
% %%%%%%   %%% %%    %  %G%
%                    %%%%%%
% %%%%%%    %   .    %    %
% %    %    %             %
% %  P %    %  %%%%%%%%   %
% %    %    %             %
% %    %    %  %%%%%%%%   %
%           %             %
%     %%    %  %%    %%   %
%     %%    %             %
%          G%             %
%%%%%%%%%%%%%%%%%%%%%%%%%%%
% % % % %%%%%%%%%%%%%%%%%%%
%%%%%%%%%%%%%%%%%%%%%%%%%%%