%%%%%%%%%%
%    P   %
%  .    .%
%     G  %
%%%%%%%%%%
% %%%%%%%%
%%%%%%%%%%
