%%%%%%%%%%%%%%
%G       P   %
%            %
%            %
%   G        %
%            %
%            %
%            %
%%%%%%%%%%%%%%
% % %%%%%%%%%%
%%%%%%%%%%%%%%
