%%%%%%%%%%%%%%
%G           %
%            %
%            %
%   G        %
%            %
%            %
%           P%
%%%%%%%%%%%%%%
% % %%%%%%%%%%
%%%%%%%%%%%%%%
