%%%%%%%%%%%%%%
%P           %
%            %
%            %
%   G        %
%            %
%       G    %
%            %
%%%%%%%%%%%%%%
% % %%%%%%%%%%
%%%%%%%%%%%%%%
