%%%%%%%%%%%%%%
%G           %
%            %
%            %
%   G     P  %
%            %
%            %
%            %
%%%%%%%%%%%%%%
% % %%%%%%%%%%
%%%%%%%%%%%%%%
