%%%%%%%%%%%%%%
%           G%
%P %    %%%%%%
%%%%         %
%  %      %%%%
%         %  %
%%%       %  %
%           P%
%%%%%%%%%%%%%%
% % % %%%%%%%%
%%%%%%%%%%%%%%
