%%%%%%%%%%%%%%
%G           %
%%%%%%%%     %
%            %
%  P         %
%            %
%            %
%            %
%%%%%%%%%%%%%%
% % % %%%%%%%%
%%%%%%%%%%%%%%
