%%%%%%%%%%%%%%%%%%%%
%                  %
%   %%%%   %%%%    %
%   %G       G%    %
%   %%%%%%%%%%%    %
%                  %
%     %%%%%%%      %
%               P  %
%    %%%%%%%%%     %
%        %         %
%        %         %
%        %         %
%                  %
%%%%%%%%%%%%%%%%%%%%
% % % % %%%%%%%%%%%%
%%%%%%%%%%%%%%%%%%%%