%%%%%%%%%%%%%%%%
%           %  %
% G   %        %
%%%  %%     % %%
%    P         %
%% %     %%  %%%
%        %     %
%  %G          %
%%%%%%%%%%%%%%%%
% % %%%%%%%%%%%%
%%%%%%%%%%%%%%%%