%%%%%%%%%%%%%%%%
%   P  %       %
%G%%%%%%% %%%%G%
%..GG      %   %
%%%%%%%%%%%%%%%%
% % % % %%%%%%%%
%%%%%%%%%%%%%%%%